row: 12
column: 12
start: 4 3
end: 10 10
map:
1 1 1 1 1 1 1 1 1 1 1 1
1 0 0 0 0 0 0 0 0 1 0 1
1 0 0 0 0 1 1 1 1 1 0 1
1 0 0 0 0 0 0 0 0 0 0 1
1 0 0 0 1 1 1 0 0 0 0 1
1 0 0 1 0 0 0 0 0 0 0 1
1 0 0 1 0 0 0 0 0 0 0 1
1 0 0 1 0 0 0 0 0 1 0 1
1 0 0 1 0 0 0 0 0 1 0 1
1 0 0 1 0 0 0 0 0 1 0 1
1 0 0 0 0 0 0 0 0 1 0 1
1 1 1 1 1 1 1 1 1 1 1 1
