row: 12
column: 12
start: 5 2
end: 8 9
map:
1 1 1 1 1 1 1 1 1 1 1 1
1 0 0 0 0 0 0 0 0 1 0 1
1 0 1 1 0 1 1 1 1 1 0 1
1 0 0 1 0 1 0 0 0 0 0 1
1 0 0 1 1 1 1 0 0 0 0 1
1 0 0 1 0 1 0 0 0 0 0 1
1 0 0 1 0 1 0 0 0 0 0 1
1 0 0 0 0 0 0 0 0 0 0 1
1 0 0 0 0 0 0 0 0 0 0 1
1 0 0 1 0 0 0 0 0 0 0 1
1 0 0 0 0 0 0 0 0 0 0 1
1 1 1 1 1 1 1 1 1 1 1 1
